objects_file = "objects.txt";
objects = [b,nn,w];
cells {
	size = 10;
	random_food = true;
	rows {
		 0 = [w,w,w,w,w,w,w,w,w,w];
		 1 = [w,-,-,-,-,-,-,-,-,w];
		 2 = [w,-,-,-,-,-,-,-,-,w];
		 3 = [w,-,-,-,-,-,-,-,-,w];
		 4 = [w,-,-,-,-,-,-,-,-,w];
		 5 = [w,-,-,-,-,-,-,-,-,w];
		 6 = [w,-,-,-,-,-,-,-,-,w];
		 7 = [w,-,-,-,-,-,-,-,-,w];
		 8 = [w,-,-,-,-,-,-,-,-,w];
		 9 = [w,w,w,w,w,w,w,w,w,w];
	}
}
